{
  "brampton-and-hinchingbrooke": [
    "111112",
    "111113",
    "111114",
    "111115",
    "111116",
    "111117",
    "111118",
    "111119",
    "111120",
    "111121",
    "111122",
    "111123",
    "111124",
    "111125"
  ],
  "stukeley-meadows": [
    "111126",
    "111127"
  ],
  "sapley": [
    "111128",
    "111129",
    "111130",
    "111131",
    "111132"
  ],
  "town-centre": [
    "111133",
    "111134",
    "111135",
    "111136",
    "111137",
    "111138",
    "111139",
    "111140",
    "111141",
    "111142",
    "111143",
    "111144"
  ],
  "hartford": [
    "111145",
    "111146",
    "111147",
    "111149"
  ],
  "godmanchester": [
    "111150",
    "111151",
    "111152",
    "111153",
    "111154",
    "111155",
    "111156"
  ],
  "houghton-wyton": [
    "111157",
    "111158",
    "111159",
    "111160",
    "111161",
    "111163"
  ],
  "hemingford-abbots-grey": [
    "111162"
  ],
  "st-ives": [
    "111164",
    "111165",
    "111166",
    "111167",
    "111168",
    "111169",
    "111170",
    "111171",
    "111172",
    "111173",
    "111174",
    "111175",
    "111176",
    "111177",
    "111178",
    "111179",
    "111180"
  ]
}